1 1 1 13 0 0 44 45 0 0 0 0 0 0 0 0 0 0 0 0 0 0 0 0 0 0 0 0 0 0 0 0 0 0 0 0 0 0 0 0 0 0 0 0 0 0 0 0 0 0
1 1 1 11 12 0 42 43 0 0 67 0 0 0 0 0 40 41 0 0 0 0 0 66 0 0 0 0 0 0 0 0 0 0 0 0 0 0 0 64 65 0 0 0 0 0 0 0 0 0
4 4 5 1 11 10 10 12 0 0 0 0 0 0 0 0 38 39 0 0 0 0 0 0 0 0 0 0 0 0 0 0 0 0 0 66 0 0 60 61 62 63 0 0 0 67 0 0 0 0
0 0 6 4 5 1 1 11 10 10 12 0 0 68 0 34 35 36 37 0 0 0 0 0 0 0 0 0 0 0 0 0 0 0 0 30 31 0 56 57 58 59 0 0 0 0 0 0 0 0
0 40 41 0 6 4 4 5 1 1 11 10 10 12 0 0 32 33 0 14 15 0 0 0 69 0 0 0 0 0 0 0 0 0 26 27 28 29 0 54 55 0 0 0 0 0 0 0 0 0
0 38 39 0 0 0 0 6 4 4 5 1 1 11 10 12 0 48 49 0 0 0 0 0 0 0 0 0 0 0 67 0 0 0 22 23 24 25 0 0 0 0 0 0 0 0 0 0 0 0
34 35 36 37 0 0 0 0 0 0 6 4 5 1 1 13 0 46 47 0 0 0 0 0 0 0 0 0 0 0 0 0 0 0 18 19 20 21 0 0 0 66 0 0 0 0 0 0 0 0
0 32 33 0 0 0 0 66 0 0 0 0 6 4 5 11 12 0 0 0 0 0 0 0 0 40 41 0 0 0 0 0 0 0 0 16 17 0 0 0 9 10 10 10 12 0 0 0 0 0
0 0 0 0 0 0 0 0 0 0 0 0 44 45 6 5 11 12 0 0 0 0 0 0 0 38 39 0 0 0 0 0 0 0 0 0 0 0 0 9 8 1 1 1 11 10 10 10 10 10
0 0 0 0 0 0 0 0 0 0 0 0 42 43 0 7 1 13 0 0 66 0 0 0 34 35 36 37 0 0 0 0 66 0 0 0 0 0 9 8 2 4 4 4 4 5 1 1 1 1
0 0 67 0 0 0 0 0 0 0 0 0 0 0 9 8 2 3 0 0 0 0 0 0 0 32 33 0 0 0 0 0 0 0 0 0 0 0 7 1 13 0 0 0 0 6 4 4 4 4
0 0 0 0 0 0 30 31 0 0 0 69 0 9 8 2 3 0 0 0 0 0 0 0 0 0 0 0 0 0 0 68 0 0 0 0 0 0 7 1 13 0 44 45 0 0 0 0 0 0
0 0 0 0 0 26 27 28 29 0 0 0 9 8 2 3 0 0 64 65 0 0 0 0 0 0 0 0 0 0 0 0 0 0 0 0 0 0 6 5 11 12 42 43 0 0 0 0 0 0
0 0 0 0 0 22 23 24 25 0 9 10 8 2 3 0 0 60 61 62 63 0 0 67 0 0 0 0 0 0 0 0 0 0 0 0 0 0 0 7 1 13 0 0 0 0 0 0 0 0
0 0 0 0 0 18 19 20 21 9 8 2 4 3 0 0 0 56 57 58 59 0 0 0 0 0 0 30 31 0 0 0 0 0 0 66 0 0 0 7 1 13 0 0 0 67 0 0 0 0
0 0 0 0 0 0 16 17 9 8 2 3 0 0 0 0 0 0 54 55 0 0 0 0 0 0 26 27 28 29 0 0 0 0 0 0 0 0 0 6 5 11 12 0 0 0 0 0 0 0
0 0 0 68 0 0 0 0 7 2 3 0 0 0 0 0 0 0 0 0 0 0 0 0 0 0 22 23 24 25 0 40 41 0 0 0 0 0 0 0 6 5 13 0 0 0 0 0 0 0
0 0 0 0 0 0 0 9 8 13 0 0 0 0 0 0 0 0 68 0 0 0 0 66 0 0 18 19 20 21 0 38 39 0 0 0 69 0 0 0 0 7 11 12 0 0 0 69 0 0
0 0 0 0 0 0 0 7 2 3 0 0 0 0 0 67 0 0 0 0 0 0 0 0 0 0 0 16 17 0 34 35 36 37 0 0 0 0 0 0 0 7 1 13 0 0 0 0 0 0
0 0 0 0 66 0 9 8 13 0 0 0 0 0 0 0 0 0 0 0 0 0 0 0 0 0 0 44 45 0 0 32 33 0 0 0 0 0 0 67 0 7 1 13 0 0 66 0 0 0
0 64 65 0 0 0 7 2 3 0 0 0 0 0 0 0 0 0 0 0 0 0 0 9 10 12 0 42 43 0 0 0 0 0 0 0 0 0 0 0 0 7 1 13 0 0 0 0 0 0
60 61 62 63 0 9 8 13 0 0 66 0 0 0 0 40 41 0 0 69 0 9 10 8 1 11 10 12 0 0 0 66 0 0 48 49 0 0 0 0 0 7 1 13 0 0 0 0 0 0
56 57 58 59 0 7 1 13 0 0 0 40 41 0 0 38 39 0 0 0 9 8 1 1 1 1 1 11 12 0 0 0 0 0 46 47 0 0 0 0 9 8 2 3 0 0 64 65 0 0
0 54 55 0 9 8 2 3 0 0 0 38 39 0 34 35 36 37 0 9 8 1 2 4 4 4 5 1 13 0 0 0 0 0 0 0 0 0 0 0 7 1 13 0 0 60 61 62 63 0
0 0 0 0 7 2 3 0 0 0 34 35 36 37 0 32 33 0 9 8 1 2 3 0 0 0 6 5 11 12 0 0 0 0 0 68 0 0 0 9 8 1 13 0 0 56 57 58 59 0
0 0 0 9 8 13 0 0 0 0 0 32 33 0 0 0 0 0 7 1 2 3 0 0 0 67 0 6 5 11 12 0 0 66 0 0 0 0 9 8 1 2 3 0 0 0 54 55 0 0
0 0 0 7 1 13 0 0 0 0 0 0 0 0 0 0 0 9 8 1 13 0 0 0 0 0 0 0 7 1 11 12 0 0 0 0 0 9 8 1 2 3 0 0 0 0 0 0 0 0
0 0 0 7 1 13 0 0 0 66 0 0 0 14 15 0 9 8 1 2 3 0 0 0 0 0 0 0 6 5 1 11 12 0 0 0 9 8 1 2 3 0 0 0 66 0 0 0 0 0
0 0 0 7 1 13 0 0 0 0 0 0 0 0 0 9 8 2 4 3 0 0 66 30 31 0 0 0 0 6 5 1 11 10 10 10 8 1 2 3 0 0 0 0 0 0 0 0 0 0
0 0 0 6 5 11 12 0 0 0 0 0 0 0 9 8 2 3 0 0 0 0 26 27 28 29 0 0 0 0 6 5 1 1 1 1 1 2 3 0 0 0 0 0 0 0 0 0 0 0
0 67 0 0 6 5 11 10 12 0 0 0 9 10 8 2 3 0 0 0 0 0 22 23 24 25 0 0 0 0 0 6 4 4 4 4 4 3 0 0 0 40 41 0 0 0 0 0 0 0
0 0 0 0 0 6 5 1 11 10 10 10 8 1 2 3 0 68 0 0 0 0 18 19 20 21 0 0 0 0 0 0 0 44 45 0 0 0 0 0 0 38 39 0 0 0 0 0 0 0
0 0 0 0 0 0 6 4 5 1 1 1 1 2 3 0 0 0 0 0 0 0 0 16 17 0 0 0 0 67 0 0 0 42 43 0 0 0 0 0 34 35 36 37 0 0 0 0 0 0
0 0 44 45 0 0 0 0 6 5 1 2 4 3 0 0 64 65 0 0 0 0 0 0 0 0 0 0 0 0 0 0 0 0 0 0 0 67 0 0 0 32 33 0 0 0 0 40 41 0
0 0 42 43 0 66 0 0 0 6 4 3 0 0 0 60 61 62 63 0 0 0 0 0 0 0 0 0 0 69 0 0 0 0 0 0 0 0 0 0 0 0 0 0 0 0 0 38 39 0
0 0 0 0 0 0 0 0 52 53 0 0 0 0 0 56 57 58 59 0 0 0 0 0 66 0 0 0 0 0 0 0 0 66 0 0 0 0 0 0 68 0 0 0 0 0 34 35 36 37
0 0 0 0 0 0 0 0 50 51 0 0 0 0 0 0 54 55 0 0 0 0 0 0 0 0 0 0 0 0 0 0 0 0 0 0 0 0 0 0 0 0 0 0 0 0 0 32 33 0
